################################################################
#<<.....#.......####...........................................#
#<<.............####...........................................#
###.....#.......####...........................................#
###.....############...........................................#
#.......#.......##############.................#################
#...............##############....$........B..##################
###.....#.......###############..............###################
#.......########################............####################
#.......#.......#################..........#####################
###.............##################........######################
#.......#.......###################......#######################
#.......############################....########################
#.......#...+++.#...+++=#############..#########################
###.................+++=#############..#########################
#.......#...+++.#...+++=############.$..########################
#.......###########################......#######################
#.......##########################........######################
#.......#########################..........#####################
#................^.............................................#
#.............................^................................#
################################################################
