################################################################
#<<.....#...%%%.####..................B........................#
#<<.....?...%%%.####...........................................#
###.....#...%%%.####...........................................#
###.....############...........................................#
#.......#...===.##############.................#################
#.......?...===.##############................##################
###.....#...===.###############..............###################
#.......########################............####################
#.......#...!!!.#################..........#####################
###.....?...!!!.##################........######################
#.......#...!!!.###################......#######################
#.......############################....########################
#.......#...+++.#...+++=#############$$#########################
###.....?...+++.?...+++=#############..#########################
#.......#...+++.#...+++=############....########################
#.......###########################......#######################
#.......##########################........######################
#.......#########################..........#####################
#........................^.....................................#
#........................^.....................................#
################################################################
