################################################################
#<<....######################..=======..$$$$$$$$$....========..#
#<<@...?.........!!%+++=!%+##..+++++++..$$$$$$$$$....++++++++..#
#####..#######...!!%+++=!%+##..!!!!!!!...............!!!!!!!!..#
#####..######################..................................#
#####..######################..................................#
#####..######################......$$$$...........$$$$.........#
#+.....######################..................................#
#####..######################...........$$$$$$$$$..............#
#!.....######################...........$$$$$$$$$..............#
#####..######################..................................#
#%.....#######.....##########......$$$$...........$$$$.........#
#####..######.+%%%+.#########..................................#
#=.....######.!%%%!.#########..................................#
#####..########?#############.................#.#..............#
#####............############................#...#.............#
#................############.................#.#..............#
#....$....^...$..############................#...#........######
#................############...............###.###.......######
#................#############################...##########..>>#
#..++==%%....................................................>>#
################################################################