################################################################
###.........#......#######.....##*.########.......!....+.......#
###@...!.%..................##*................##############..#
###.........#......#######.....##*.########..=.#####+++^.......#
###############....#############################################
###############....#############################################
###############....................................#######%!=!%#
###############....................................?.....%+++%%#
###############....................................#######%!=!%#
###############....#############################################
#..*.+.+.*..###....#############################################
#.....*.....###....#############################################
#..*.....*..###....#############################################
#...........###....#############################################
#####...#######....#############################################
#..........................##..^..######.......................#
#..........................##*.^.*...%##.......................#
#..........................###...###.###.......................#
#..........................###...###.###.......................#
#..........................###...###.###.....................>>#
#................................###.........................>>#
################################################################