################################################################
#<<....######################..=======..$..$$$..$..$.========..#
#<<..............!!%+++=!%+##..+++++++..$$.$$$$......++++++++..#
#####..#######...!!%+++=!%+##..!!!!!!!.$$...$$....$..!!!!!!!!..#
#####..######################.................$....$...........#
#####..######################.........$....$..........$........#
#####..######################........$.......$$......$.........#
#+.....######################......$$.....$....$...............#
#####..######################..........$$.$..$$$....$..........#
#!.....######################.......$.$$..$..$...$.............#
#####..######################............$$.$....$.............#
#%.....#######.....##########.............$.....$....$.........#
#####..######.+%%%+.#########....................$.............#
#=.....######.!%%%!.#########.....$............................#
#####..########?#############.................#.#..............#
#####...^........############................#...#.............#
#................############.................#.#..............#
#................############................#...#........######
#.....$..........############...............###.###.......######
#..............$.#############################...##########..>>#
#..++==%%....................................................>>#
################################################################
