################################################################
###.........#......#######.....##..########....................#
###.........................##.................##############..#
###.........#......#######.....##..########....#####...........#
###############....#############################################
###############....#############################################
###############....................................#######.....#
###############................................................#
###############....................................#######.....#
###############....#############################################
#...........###....#############################################
#...........###....#############################################
#...........###....#############################################
#...........###....#############################################
#####...#######....#############################################
#..........................##.....######.......................#
#..........................##.........##.......................#
#..........................###...###.###.......................#
#..........................###...###.###.......................#
#..........................###...###.###.....................>>#
#................................###.........................>>#
################################################################
